_ _ _ _ _ #
# # # # # e # # # # # # # # # # # # # # # # # # # # #
# . . . . . . . . . . . . . . . . . . . . . . . . e #
# . . # # # e # # # # # # # # # e . . . . . . . . . #
# . . # _ _ # _ _ _ _ _ _ _ _ # . . . . . . . T E . #
# . . # # # # # # # _ _ _ _ _ # . . . . . . . . T . #
# . . . . . . . e # _ _ _ _ _ # # # # # # # # # # # #
# . . # # # . . T #
# . W # _ _ # # # #
# @ A #
# # # #