# # # # # # # # # # # # # # # # # # # # # # # # # # #
# e . . . . # . . . . . . E . . . . . . # . . . T T #
# . . . . . # . . . . # . . . # . . . . # . . . e . #
# e T T . . . . . . . # . . . # . e . . . . . . . . #
# # # # # # # # # # # # A @ W # # # # # # # # # # # #
# # # # # # # # # # # # # # # # # # # # # # # # # # #